xxxxxxxxxxxxxxxx
xp            fx
xxx xxxxxxxv   x
xs  xsx   xv  sx
xxxxx xxxxxv xxx
xv            vx
x  xxxxxxxxxxxxx
x              x
x  vs  vv  sv  x
x  sv  vv  vs  x
x              x
xxxxxxxxxxxxxxxx
